Sybil A|Sybil Kailena
Mirka|Mirka Bay
Nici Dee|Ti Sato
Melena Maria Rya|Melena Tara
Yarina A|Yarina P
Rinna|Rinna Ly
Shania Vega|Shania Vegax
Maria Rya|Melena Tara
Melena Maria|Melena Tara
Niemira|Niemira Foxx
Viola Bailey|Viola Paige
Mayuko|Mayuko Ryuzu
Sabrisse A|Sabrisse Aaliyah
Ryana|Stefani Kovalyova
Miriama Kunkelova|Mirirama Kunkelova
Silvia Wise|Sylvia Wise
Vicki Wade|Vickie Wade
Milan Cheek|Milancheek
Nikoleta|Nikoletta
Maria Rya|Melena Maria
Adel More|Adel Morel
Mila Amour|Samadhi Amour
Suzanna A|Suzanna Aye
Maria Rya|Melena Maria Rya
Mia Lee|Nedda A
Sally Minx|Sapphire
Maxa|Maxa Saloma
Viola Oh|Viola Paige
Sarika A|Sarika Ahe
Melisa Mendiny|Melissa Mendiny
Nekane|Nekane Sweet
Silvie|Silvie Delux
Viola Bailey|Viola Oh
Rahyndee|Rahyndee James
Sabrisse|Sabrisse A
Tracy Delicious|Tracy Lindsay
Mencia Francis|Mercia Francis
Sara Luv|Sara Luvv
Melania|Nika Murr
Vanessa A|Vanessa Angel
Melena Maria|Melena Maria Rya
Xene|Xene Jay
Zuzana Z|Zuzana Zeleznovova
Sabrisse|Sabrisse Aaliyah
Milena Angel|Milena Rebrik
Sophia Sweet|Sweet Sophia
Raylene Richards|Zuzana Drabinova
Noel Monique|Noelle Monique
Polly White|Poly White
Roxanna Milan|Roxanne Milana
