Abella Danger|Abella Danger Pics|
Adel Morel|Adel More|
Taissia Shanti|Eva Shanti|
Skyla Novea|Ginger Elle|
Nici Roxx|Ti Sato|
Rinna Ly|Rinna|
Tanya Grace|Rita Y|
Roxanna Milan|Roxanne Milana|
Stefani Kovalyova|Ryana|
Sabrisse Aaliyah|Sabrisse|Sabrisse A|Sabrisse A
Sally Minx|Sapphire|
Sammi Tye|Sam Tye|
Sara Luv|Sara Luvv|
Sarah Nicola Randall|Sarah Randall|
Sarika Ahe|Sarika A|
Selena Santana|Selena Rose|
Shania Vega|Shania Vegax|
Sylvia Wise|Silvia Wise|
Silvie Delux|Silvie|
Skye Wood|Skye Young|
Vic Marie|Slimthick Vic|
Zuzu Sweet|Sofia The Bum|
Sophia Sweet|Sweet Sophia|
Sophie Moone|Sophie Sweet|
Suzanna Aye|Suzanna A|
Sybil A Kailena|Sybil Kailena|Sybil A|Sybil Kailena
Taya|Vikky|
Tiana Blow|Tori Mack|
Tracy Lindsay|Tracy Delicious|
Valerica Steele|Val Steele|
Viola Paige|Viola Bailey|Vanea|
Vanessa Angel|Vanessa A|
Veronica Zemanova|Veronika Zemanova|
Vicki Wade|Vickie Wade|
Victoria Rae Black|Victoria Rae|
Viola Paige|Viola O|Viola Oh|
Violette Pink|Violette Pure|
Xene Jay|Xene|
Yarina A|Yarina P|
Yoha Galvez|Yoha|
Zelda Bee|Zelda B|
Zuzana Zeleznovova|Zuzana Z|
